# Map 2
# Start goal pairs:
# 1. Start: (0,0) | Goal: (14,14)
# 1. Start: (2,10) | Goal: (12,3)
# 1. Start: (13,7) | Goal: (1,13)
................
.XXXXXX.........
.......XXX......
..XXXX.....XXX..
..X..........X..
..X.XXXX.XXXX...
..X.........X...
..XXXX..XXX.X...
..........X.X...
..XXXXX....X....
..X...XXXXXX....
..X.......X.....
..XXXX....X.....
.......XXXXX....
................